1111111111111111111111111111
1000000110000000000110000001
1011110110111111110110111101
1011110110111111110110111101
1000110110111111110110110001
1110110000000000000000110111
1110110110111111110110110111
1000000110111111110110000001
1011110110000110000110111101
1011110111110110111110111101
1000110111110110111110110001
1110110000000000000000110111
1110110110111001110110110111
1000000110110000110110000001
1110110110110000110110110111
1110110110110000110110110111
1110110110111111110110110111
1000110110000000000110110001
1011110111110110111110111101
1011110111110110111110111101
1000000000000110000000000001
1011011110111111110111101101
1011011110111111110111101101
1011000000000000000000001101
1011110110111111110110111101
1011110110111111110110111101
1011000110000110000110001101
1011011110110110110111101101
1000000000110000110000000001
1111111111111111111111111111