111111111111111111111
100001000000000100001
101101011111110101101
100101011111110101001
110100000000000001011
110101011111110101011
100001011111110100001
101101000010000101101
100101111010111101001
110100000000000001011
110101011101110101011
100001011000110100001
110101011000110101011
110101011000110101011
110101011111110101011
100101000000000101001
101101111010111101101
101101111010111101101
100000000010000000001
101011011111110110101
101011011111110110101
101000000000000000101
101101011111110101101
101001000010000100101
101011011010110110101
100000011000110000001
111111111111111111111